1111111111111111111111111
1110000011111111100001111
1000010000001000000100001
1010111111101011111110101
1010000100000000010000101
1011110100001000010111101
1010000000111110000000101
1000000000000000000000001
1111101001112111001011111
1000000001333331000000001
1000001001111111001000001
1111100000001000000011111
1000000100101010010000001
1001101110101010111011001
1000100000000000000010001
1100100101111111010010011
1000000100001000010000001
1011111111101011111111101
1000000000000000000000001
1111111111111111111111111