1111111111
1000000001
1011011001
1000001001
1010100001
1010100121
1000000131
1111111111