1111111111111111111111111
1000000000000000000000001
1011101110101111101010101
1000000000100000100000101
1010111000101100111111101
1000010000000100000000001
1011010000100100111111101
1000010000000000000000101
1000000000000000011110101
1001111001122110000010101
1000000001000010000010001
1001111001111110000110101
1000110000000000000000101
1000110000000000000111101
1000100000001110000000101
1001000011100000011100101
1000011100000000010000001
1011100000111000010111101
1000001100000000000000001
1111111111111111111111111