111111111111111
100000000000001
101222101001001
101333101001001
101111101001001
100000000010001
101000010000001
100100100001101
100010000110001
101001011000001
100000000000001
111111111111111